0 15
9 139
9 28
84 156
80 106
8 137
92 154
29 93
118 156
1111111111110111110a11111110110101110111111011011111111111a1111101111111110111111011111101101011011110111100111111111111011111101111a111111010101110010111111111
1011111111001122112b11210121102201110111121011110111111111a1011101001001111110111011110111110011111011111111111101111011111122211120a112012212212021010121111100
0101111111110011221b20001111120212122211110211011111101101a1101101101111111110110111101110101111011111010111111111111111100110110110a212122210021011121201101101
0111000111111201212b11122122211202112122122100111101110010a1110001111111010111101101101111111101011011011111110110111110111112100202a122222101110111012110111111
1111011110011022212b11111112200222112021122111111110011110a1110101111111100101110111101111111001110111000110111101111101111121110002b110211222211121211111111111
1111111111111121121b02110020222201211212222211111111001111a1110110011111111110111110111001001111101111111111100011111111111202221011a002012202222121222121111111
0111111111111212012b12021212100211111120221211111111011110a1111110111111101111011111110111011111111011111111110111011101112121221222a101122102102112212200111111
1111011011100122222b00120020112101101101021211111110111111a1101101111100110100001110111110011101111000111111111101101010102220221212b210212102100202102220110011
1110111111111122111a20201220202221010221012111011100101101a1101111110110111111111100111110111111111011111111111111110111012122122202a111122112221211121221101110
1111111111110112211a21212002221221222020110011111110110110a0111011111101111111111011010110110110111111111111110111101111112111221121b011112122012221010001110101
1101110011010012220a11122201202201220211221211111101111111a1111111111110111110101011111101110011111111100111001111111011101021111221a2120110aaaabaaaabbbaaaaaaaa
0011111001101122221a11112121121001202022201110010011111111a1110000111010001111010101111111100110111111110111111111111111110022101022b0000022a1121102011121111011
1101111011111211221b12012212000022220121211011111001111111a1111111111111110110111111111101111110110111111111101111111111111221200012b1012111b2222111211121110110
1111111101111120202a21011220102010112211220011111111110010a1111111100111110110101111111111101111110100111100111111111101111222121212a0211212b0211212121111101110
0111101111100121101a21122122222012212121212211111111011000a0111011110111111111122222210112212222022200101012201111011110111101112112b1112000a2022122212220100110
0011111111101210202a20201110101120011121101110101111111111a1011111111011111110011111112221211211101111222112210110111010112220221202a1112122a1002020122011111010
1101111111111111222b01201221102111220212112210001011101001a0011111110101111011022202212221200222011220121220001101111111112211002211a0220220b0022112021110111111
1111110111101221122b10012021100221211012012100111011111011a1101110111011111110212112121200112100111111002012211101110011011120212021b0221101a2000112122121101010
1110010111111222012b10022111211021121221111111110000110110a1011011111110111110000212100221212020200001221122100110101111111212222101b2120010b2110211221101100110
1111111110011110221a21121121210021110212221011111111111111a1111111011111001110122201021121221002112121221012211001101011101202012111a2102022b2211221112121011100
1011111111111212112a11120210200222222102222211111111101111a1111111110011111111222222122021211210201221111121110010111111112002221202b2112102b2020011022221110110
0101111111011201222b12111220100120210120022011001010001011a1111100101111110111200200111210220001222022112122211111101111102210202101a0012122a2022001220111111111
1011111111111111121a11112110101201021212202211100010111110a1101111111111111111020202202221011110220120001012201110101011101110212212a2122210a2212201001120011101
1101111011101201112a12100211211222211220102101111011010100a1111111011111111101210201101210110221021211221121211111111101111221002122b1101021a0121011121201000101
1011111101111111110b22202101121001201022211011111111101111a1001111111101111110112211202112200122111201001022101111111111111111110011a0111111a1001011101101111111
1111110110100010100a11010111111100001111111111111011010111a1111101111101111100120101111012221222112022202110211011011111011111111111a0100010a1111111111111111001
1111111111101111111a01111101011111110110101111111011110001a1111111011111011111011201222122201012211222221221010111111111111101101111a1111110a0101111111011111011
1101110011111100001a11111111110111111111111110111111101111a1111111111101111111222101221121120211210210100211001111110100101111111111a1011111a1011111110111111101
1111111101111101010a11011111011110111100111110110111110101a1000101111110001101012201222112122212121221201221111011111101011111111011a1111100a1111011110011111111
1100111111111110111a01111111111111111011111110011110110111a1010111111101111111112112100112201212202212210220211110101111101111111111a0010111a0111111001111101111
1011111111111111011a11110011011111111001110000111111100011a1111111010010111101221110121101011221212121121212211010111111111110111101a1010100a1111000011111111111
1110111001101101111a11001111111111101101101011111110111101a1011110111011110111111102001222122022122112011222110111011101011110111101a1111011a1111111111111111111
1110101111101100111a11111110111110100101011111011100011111a1111111111110110111021100010221210101211011101110111111111101111111111111a1111111a0111111111111110111
1100110111111111010a11011111111111101111101100101101110110a1111111110110111111111120022100221122111012212111211011111000110010011111a0011111a1001111011111100111
1111110011001111111a00111111011100011111111011101111011111a0111111011111101111212212012211221210211111220112111111011111111111111111a1001111a1111111111110111011
1011101101101111010a11111011111101111111110111111101111111a1111001110111111111021101210122211122202022202022201111111111111011111111a1111000a1111111110111111101
1101110101111111111a01011111111111101111101110011111101111a1101111111011011011012212121122021122212102121111111111111110110111110111a0101101a0101101111101111111
0110110010110111101a01101111010111011100101111101111001100a1110111011101111111020110012002012020222222211102101111110111111111101110a1100101a1110110100111111111
0111011101111011111a10111101101111111110110111111100111011a1010111111111110111202211111222210110221122221002111101011101011111111101a1010001a1101111110011011111
1111111110111111111a01001110110111111101111111100100111111a0011101011011011111120111120222011121122221200212211100111111011111110111a1110111a1011111111111111101
0101100111111111011a11001110111100101110111110010111100111a1110111100110101111100202120210021212221202121112211101111111111101111011a0111100a1110110101111110111
1111111011111100101a01010101101111111101101111101101111010a1011110111111001101210012220112202220012110221211011110111111011101011000a1111111a1111111011110111111
1011111101111111111a11100111111111011101011011111111011111a1100101010111111101021101210102012122112121111111011111111111101101011111a1110111a1011111100110101111
1010011100101110111a01111111101111110001110111101011101111a1110111111101001011221121222122112122221211201102111101100001111011111101a1101111a1110101011011000111
1101111100111101100a10111111111111111111000001101111111010a1111111111111011110112011212222122011211211122201001100110111111111011101a1110010a1111110011111111111
0111001110111111111a01101100101111110010101111111111101011a1110110001111110101110011101010101010001101011111111101101110110111111111a1111111a0111111111101111111
1101011101111101111a10111010111111111111111111101111111001a1011011111110111111110101111111110100111101010110110111101111101111111111a1111011a0111110011111101111
1110111111111101111a10111111101011111111101111111001111111a1000111100110111101111111111111111111111011011100100111111101001101101011a1110111a0111111110000111110
1100101010111101101a11111110110111101111101111111101110011a1111101110111011011101100111101111101011101111111111111110011101111011111a1111111a1111111111011110001
0111111011110111100a11100110110111101101101110111011111111a0111001111101110011111111011101011111011111011111111011101111011101111101a1111110a1110111011110111110
1111111111111100001a01111010111111111111010111111101111111a1010011111111111111111111111101011111011111000110101100110111101111101111a1111110a1111101111010111101
1110101110111110101a11011111111111111111110111111110010000a1111110111111110111111011111011110011101111110011111111110100111111100011a1111111a1001111011110111111
1010111111111111100a11101101111111110100101110110011110111a0011110110111011111111111001111111111111111111111111111101101110111111110a0110111a1111110100011111111
1111111101111101111a11111100110011101010111000111111111111a0101111101111011111001111111011011110111111011101111101111111001000101111a0011111a1111101111110111100
1010111110110111111a10011011011101111101111111011011111111a1101100110100011111101111011111111000001111111101111111111111111011111111a1011011a0111101111111111111
1101111111111101011a01111100111111111011111111111111111111a0001110111111111110111110111110110101111111111111011111111101111111100101a0110111a1110111100101001010
1011111111111111011a11010111011101111111111010111011011101a1111111010110111111110101100111111011111111111111011110011101110111111011a1100011a1010111011110011111
1100010011111111100a11110111111110111110111111111111111111a1010000111111111111111111100111111111110101101111110110101001111111111011a0101111a1110101110110100111
1111111111101110111a11110111100111001011110101100101110100a1110101001010110110111111011011111111111101111111001111101110101011010011a1100111a0111011111111110111
1110111111101110111a11111000111111111111111110110111111001a0111110111101111001111111111111111111111111011110111011111111010011001111a0101111a1010111111101110111
1111010111111101100a10111111111110110011011111111101111111a1010101011101111111111101011111111101101110111111111111010111111111001111a1101111a1111110111011111110
1011110111111111110a11101111111111111111111111111001111110a1111111011110010111110111111111011111101011111011110111011111011111111110a1111011a1111110001111101111
1111111111111111110a11111010111111111011011110011110010010a1011111111111100011111011111101101110101011011111101011111111111011111111a1101111a1010011111111011111
1111110111011111111a01111111111111111111111111111010111111a1010111111111011111011111101111110110111011110111111011110001111111110101a1011110a0101110011111111110
1111111111101111111a11011111111100101110001111111111100010a1110110100111111101111111011110111111110111111011011111111101011111111111a1100011a1101111111111100111
1101011111111110111a11111101000011111110101111111111110111a1101111100111101111100101111101012121211111121102120212200221111101111111a0111111a1111110111111111111
1011100111101111001a11101101011111110111111111010011111110a1100111110111111101111101011110122221200222112022122012201121201111011011a1110111a0111111110111011101
1111111101001111111a11101111111111111111111111101100111101a0100111011111111001011111111000111102112212100121220012121211121111111110a1011101a1111010101111011110
1111111111111100111a01011110111011111101011111011101110111a1111111111110111011111111110111102111121101011111012212212201221111111110a1111101a1111100111111001010
1100101101111011111a10111111110111111001111101111111110111a1111111111111111001110111110111022222120222020111222110221221221011111011a1111110a1121010211201121120
0111101111111101111a01101010111111111100011111111111101111a1001111111111001001110001111010011120210111001212112100211111211111100111a1111111a2201111112211112112
0101101111111111010a01110111101111111111101011010101100011a1111111010110111111100111100011111111102212220112221222201002011010111001a1111011a1222121202211111110
1111111111111111011a11111111110110111011101111101111111111a0111011011111111111111111111110122122211120012121200221122101221110101101a0111111a1121022221011120011
0100111110111100110a01111100011101111110010011111101111111a1101011110101111111011111111011112212022021210222211211001112111010111000a0111010a2202111221101202111
1100110111111111110a11111011111111001011110101111111111001a1100011111101010111111101111111101112122201120211210002221022021111111010a0111111a1211012100201100102
1111011110101111101a11101011110001110011111111111001111111a1111011011111100111101111011111022122120012010221121221222022222211201221b2212212b0211110101211112011
1111111101101101110a11011111101111111111111001101111110110a0101110111101111110110110111101122110112200212001011202202201221120111012a2221202a2221120211221012111
1101111101011110110a11111110111111010111101100101111111000a0110101111111111101111010111111120122002111221211222212001222122002121122b1112221b2000102122201202022
0101000111110011001a11101101111111001001001011010111111111a1111111111111011111101000111101001210212121120012102102222002122012121211a1121112b2211002222000222021
1110111100011111101a11111111110111110111111110111111111111a1111111111001111111111111011110112112020102212122202220202221011211121211b0122012a2021222220122222222
1111110011011101001a0111111101011111101aaaaaaaaaaaaaaaaaaaa1110111111110011111110001111011121122122210010002202001120222002002011221a1011112b2211212221222220220
1111111111111111110a1011101111011101000a10111111011111001100111111111111110011111000111110021022022210202011111122212210022021100200a1001022b2002221001211112211
1101010111011111111a1111010011111011111a11010111111001111011111111101111111101101111111111121121210212211122111102122020202220110222b2121121b1200222211002020221
0111110111111111111a0110011111111001111a11111011111011011111100111111010110110111110101101112220122200211200201122222120102211101110b2212122b2212122220222202120
0111111110100111111a1001111111100011101a11011111111101110111110111011111111111111111001111111221202121111011021022222222201001011010a2112112b2102221222020221120
1011111001111111011a0010111110111111110a11111100111111101011111111111111111111111110111110022010102121112201221122210200222102102111a1112012b2112212202222222221
1111100110111110011a1101101111110101111a11111111110110111110111111111111110011111111011011021212222201112211201121221220222222021102b1112022b2212212002222222221
1111111111111111011a1111110111111111110a10101011111111011111111111011110000110001101110111120021102220111211200222100102201211101110a0121022b2122222022112212022
1011111110111101110a0111011011101101111a11100110111010011111101110111111101011101111111011012101022120000222102120021222220222111212a0112111b2222222022022222221
1110111011111101111a0111111111111100110a11010111111011011001110111011101011111110111111111112222211001021021221120122120222121021122b2121002bbbbbbbbaaaabbbbbbba
1111101001111101111a1110111111001111011a11111111011110011001010111111111111111111110110111101222121000112112211212202020120212212212a021221020212121212202022222
aaaaaaaaaaaaaaaaaaaa1111110011110111111a11101111111100111100111111100001111111011111111111121211122221212201111122222222221102210211b022211212020021212102222200
110101111111111111011111110111111110010a01111111111111011111110110110111111111010101111111100211122220112112112122102220200211210101b121121222112012022212201121
111111101101101111011011111111011010111a00011111111111001111111011110110111101111011111111022201022021211212010222220022211210221112a121120222222022220021202212
111111111111111100111110111111011111111a11011110111101110101111111011111111111111111101001022102002211110112202220012202212000220221a202212222022222120022002201
101111111110111111101101011011111101111a10110011111101110111101011111111011101110110011100112102121000212121201022202221222012121222b200211222112012122201100022
010111111111111110010101111011111111111a11111010111111010111111111110111110110111101111110011111100101111110111021220102021020211110b222102222222221020112112200
101111111101111111011111110111111011111a11111011101110111111111110111111111010111110111101111110011111110110111222121212121021102210b222211022222202122222021100
010000111101111111111111111110111111011a11101110101111111111111000110111111111111111011110111111011111111111111020220002020010021122a122002221122022111001012222
111101111111110101110111101111111111111a11111110011101101011110111110110111111101011111111111011110111100111111111201101212100011122aabbbbbbbbbbbababbaa00212201
111111111101101111110011111101111110101a111110111111111111011111111110110010111111111101000111101100010101111112022200121200111222220121222222222112212b12221120
111111011101111111110111001111111111111a111101111011111111111111111110111111101111011111111100111111111111111011222221012201012011111112120222120211212b12122202
101011111111111001111111101111011011101a011101011001111111111011111011110101111111100111111101010111011111100010221022121020122100221202122212211101202a01120101
110111011111010111111100111111111101001a111111111111111111111010111111111011110110001111011111001111011111111110020222011212112222221020202222122211210a22221002
010011111101111111110111111110101111111a110111111110110111011111111111101111111111101111111111111011110110111110220101222221112121111112220102021021202b20222211
100111111111111110111111110110111001101a111110001110111011110111011111101111011110111011111110011011111111110112001111121202120022122111212221220220221a21222222
111001011111110110110100011011111111111a010111111111101111011111101111111111111111111111111101011101011111101111111111111100111111110111011110222221210b00222221
011111011011111011110101111111000111111a011010101111111111111111100111010110111111111011110101011111111011110111111111111111110111111111110022020222222b01221100
011111110101111111110101011111111101010a111111011101111100110111111110101011011111110111011111111011111101111101101101111001111101000101111111111202202b22121112
110000111111111111111111110110111101111a111111011101111100111101111111110111001111100011111111000010011110101111111011111011111011111111011111121012121b22121220
111111111111011111111111110110010111000a110111001111000110110111101111111111110111011111111110110110111111111110111111011011111011111110011111002000222b22101202
111110110011110111111111011100111010100a111011111110110111110111111101110011111110010111111101111011011111111011111011111111010110111111101101010222112a11111221
001110001101010111111111111111111111111a011111111111110110010011111111110001111100110101110111111111011101101011111100111011110001011111100102210020112b12021101
011111001110110101011111100111111110111a011111111111111011111101111111111111101010111011111111111101011111111011111111110101011111111111101111021121120b21021111
101111010101111101011101111111110011110a111001011111100011111111111111111011111011011111111101101100101111111111101101101111111101001111101110201122122b11112220
111011100111111011111111011111001010111a001111111011111101101101011111001101111110111111011111011111111111111111110111111011011011111110101111120212212b11221222
111111101111111101010111111101011111011a101111111111100111101111100010111111111111111111111110110110101111111011111110111111111111011111111012210112021b12011112
101011111101111111011111110101011001110a101111101011110110111111111111110101101110111111111111111111010110001110111111111100001111111111111111221101202a11012120
111011110011110111101101111111110111111a111101111011011111111111111111101011010101111011111111001101111100100111111111011111111111111010110111211210022ababbabbb
110111101011101110111110111100011110011a111100111111010110111001101111011111101101111111111100110101100111111110111110101111011101011011111112220221102110012220