17 17
16 152
71 1
76 132
44 84
52 143
106 145
84 60
41 92
45 84
11100111110111011111110111111111100111111111011010111111111101111111101111101111101a1101111111101110111111111111111011111100111011001101100a101111111110111010a0
11101101111101110101111111111111111111111111111010011111101111111110111111011101111a1111111111011001110011111101111111111011111111111111010a111111111111111100a1
11111101111100101111111101100111011111111111111100110101110011111111011111111100110a0111110111101111111101111101111110111111011111111111111a101110111111111111a1
11111111111110111111110011001100000111110111011011011001111011011111111101111111111a1110101110010111111110111111110100111101111111011011111a011110110111111011a1
11110101111011111111011101111111101111111111111111110100111111111111111110111011111a1111111111111111101011111011111110001111111111111111111a111111111010011011a1
01101100111111111111111111101111011111111111111111111011111111111111111111111110111a1111111110111010101001111101111111101011111111011101111a110110101111011111a1
11111111111111110111101111111111111011001010101111011011101101111100111111111011111a1000101111010001111111011111111111111111111111110111111a111111111111101111a1
10111110111111111111111000111011111101010011011111101111101111111101111101111101101a0101111101111110011110101111111010101111111111111110111a010111111111101010a1
10101111111110111101100111110111111001101010111001000011001100111011101111111110011a1000111111111111011111010111111111111110111010101011111a011111111100110111a1
11110111011111101011101111111110110001100111101111111101101011011011111111110111111a0101111111111110111111111110011111111111111011011111110a111101111110101101a1
10110010111111110101101111011110101010111111111111110111111111011110110100101101111a1111111011111000110111110111111101101111111011001110111a101111111100101111a1
11100100011001011011111100111111110111111111110111111100101100111111111000111111001a1111110011110011101101111100011111111011001111111111101a011111110111111111a0
11111010111111011010111111111011111111001011111111110111111011011111110101011011101a1111010110101110111111111011111010101101101111110101111a111110111101111111a1
11111111110010111011011111011101110101111110010110110111001101111111111110101111011a0110111111111010001111111111111110111111111101111101101a110111111110111111a1
10111111111001101111111111111111011111010111111111111111110111011101110101011111111a1111111111111110111111011101111111001111111111110111100a101111111111010111a0
11101111111111110111111111111111011111111101111111001110111111101101111111101111111a1111011011111111101111011111110110101111111111110100101a011111011110111011a1
01111010101111011110111111010111011010111101101111111111011111111111111111111111110a1110111101011101101101011111001010101111111111011000101a111100001110111111a1
11011111100100110111011111011101111011110111010111111110111111111111011110101101011a1011111101111110110110101101101111111111111011111101101a011110110001110111a1
11111011011111110111100110111111110101111111111101111101111111111011100001101101111a0111101011101011011110011111011111111101111111011111101a011010101111010110a1
11111111111111011110111111111111111111111111110111101011101111111101111101111101111a1110110101100111101111011111111111110111001011111111011a000110111111100101a1
11101110111111111111101101100011110111101111100011101111111111111001111111101110110a1101110101110111110111010111110011111000111101111001110a111101011111111111a1
01111111011100111111011111111011100111111111101111111001101110111111111111111101111a1101101101110111111011011111111110010011101101111101001a101111111111101111a1
aaaaaaaaaaaaaaaaaaaaaaaaaaaaaaaaaaaaaaaaaaaaaaaaaaaaaa11101111100111111011111011011a1111101011110001011100111111111111111110111111110111111a110111100011011001a1
10110100001011101101101111110101111011011001101011100a11111101101110110111011111011a1011110111110110111010111011101111100111111111111111111a100100111101111100a1
10110111111111011111111101001110101110111111111111111a01111111110111010111111111111a1101111111111111111011111111110111111101111011111110111a111111111011111110a1
11111111110110110010111111011111101111110111001101111a11011111110111111111111100110a1111011101111110001011011111110010111111111111111101110a100111011011110101a1
10011111011111110011111111111111110001101111111101101a11111111111111111101111122211a2201212212221200121102111111101111011111110001101110111a011111111001111111a0
11110111111111111101010111101011101001101101011011011a01101101111101111111111000201a2200221110201222110110021111101111011110111101001111111a111111110011111111a1
11111110011111111110111111101100011110011011111110111a11011111111010000111101112212a0111111012210212220102201111111101011111111111011110111a111111111011111011a1
11101111101011011011010111111111111111101011111111111a11111110111111121002111222122b2022201020021121221212111110111111111101111010111111111a111111110110110011a1
11111011011111111101011011111111111101111001011110101a10011010101111122221200222222b0201200222222220221212201110111111111101101111111110111a111110011110010011a1
11111111110100001001110111111111010111111111110011111a11111111111100112222212220120b2220222202222200212202011110111111111101111111011111111a111010111001110110a1
11111110111011101101111111111111011110111100010010011a11110001110101102202202222121b2222222221202222212020121111011111000101011111011110000a101111111100101011a1
11011111111111111111001011111111111101011111001111101a11101111101011100122121222222b2222220222202122201001221001111111011111111111111110111a111101101101111111a0
11111011011111001011110011011101010101111111101111111a11111100111111021002222222222b2002222022002222122211211111111101111111111111111111000a111111111111110110a0
11111011111111011011101110110111101011011110111111111a11001101111111122222122202222a2222210200212222202000211110111111100111111010111101101a110111111011111011a1
11011111011011011110111111100100111100111110101101111a11101011101011122200122222112b1202202212211222112112210110011100001111101111101011010a111011111101100010a1
11110101101110000111111111111111011111110011111100111a11111111111110002220100220120b0020202222212122121011221111010110011011101111220222002b100212201211012121a1
11011011111111111011110110111111011111111101101111111a10111111010111102202202202210b2021112210202102222211210111001101111110110121111221101a112022102121222001b1
11111011111110011101110111001111101011011111111101111a11111111111111001222222222212b2222201220212122020010221110101111100010111101212222221b122012121001212110b0
01011111111010110111111111011101111111101111101111101a10111111111111102202102212002b0100220222122122001012121111011111111111001111122221121b220120010222000012a1
11111110010111111101011111111111111111111110111111111a11111111110111122222121200212a1221222220122022122121201111011111111111101022011210211b201101020001010210b0
11111111011110101110111111111111011110111111111110101a11011011101111110222120202222b0022022212022222102221221110000011111111111120112100221b211012112212210011b1
10111111110011011011111111110110001111111111101011111a01111101111111102120120210222b2222222122122222122221011111111011111111111111121111220b211222211222121221b1
01101111011111111101101111101011111011111011111101111a11001110111111112022211102222b1210122212122222211210221110111111001101011110101220121a021211121012202222b1
11111111011111001100011111111110001101101001110111101a01111110110111102222222221020b0222022212202221222201111110011101011111111111110222022b211221012111112121b1
01011011111110011111101110111011111111111101111011111a11110111100111122220222200222b2220122122020221212221121111011101111111110120212011201a022102001021121210b0
11111001111110110011010111111010111110111111101101111a11111011111111122222222222000b2202020002120222221011001111111011110101111121011201212a210201212012112111a1
11011101011111001111011011110111111101111001110111100a01111111111111100201010201011b2222102002212220110110021111101111111111011011121121021a012212110122211211a1
10111101010100111111111111111110111101101111110011010a11100110011011122022012202001a2022202222222222021200011101010111111101111111220211102a000102121121021121b1
11111101101101011101111101111111011001011101111010101a00110111110111001202222220210b1222002220212021212210021110110011101111111112111221221a011221220220221101b1
01010111101111101111101111111111010111111111101111111a11111111101110022222021202020b2222220020202022222122121111010111110110101100222122112a111211211121221021a0
10010101110110101111111001111111111011111011011111011a11111111100100102222001222000b2222122221222220110000111011111011111011101011121220010b222211210221222011b1
10110111111111111110111111101101111011111011111101100a10111111111001101201122212122b2201222222122022011211221111111010011100111122122201122b111111121220202112a1
01110111111111110111111111111110111111111111101100011a11101111111101102211222202212b0200222212222022211211101111000011111111011122111211120b122121220112121111a1
11110101110110111011011101111111110010111111110111111a01111110111011122022021222102b2202212221220220211212011111111110110101111110211002012b111211101102211001b1
01211221111211222111111111111111110111111111110011111a10111101111111121222200022022b2122220222222202002212120111111111101111111121200122212a121121122112012212b1
01112121211112110111111111101111111111111101101100011a01001100111111122001021201210b2122020222200222111110101111011111011111100112120222200a222212102121202121a1
01111112221012001011110111111111101111111111111111111a11111111111110120202210112220b0222210022220201110101111111110111011101011020011211212b111201001022221100b1
11022100002120012011111111111111110110011110110011111a10111111101111112220121202111b2112211221220012110111011100111111110010111112112101012baabbaaaabbabbaabaab0
11021211200221220110001111111100111111110101011111110a11011111111010111221122212111a0121120211021221111101110111101111101111111121111011221121222101220121212221
1210112202222111110101101111011111aaaaaaaaaaaaaaaaaaaa01111111111111111111101111111a1110111101101111111110111110111110121112010100101012012122222212022212120121
1110211121221212111111110111111111a111111101011001111100101111111111111111111110110a1010011111101111111101111111111012102011200122222020201222102222111001221221
1112120111121010011011011111110111a111011011011110010111111101101001001111111011110a1111011111111011111111101110111111220020111212022222221202022012121221100021
0121220211011202000111001111011101a111011111011110111110110111101111011110111111110a0011110111010111111011011111111012121201201100211122222012212222221001221020
0221211222210111211111111011111111a100101111111111111111111011011111111100011110011a1111101111111101111101011111101010111120212012212212000202002111221001101221
0221102101212212010101110101011111a111010111110110111110111111011111111111111110010a1101111111111010110101111111111110202220212212221212222222222200121222220221
1102010122121021211101111111100111a111101110111111111101111011101011111101010111001a1110110111101111101111111101111112121101111220221122202200222221221221202001
1221200121120022100011111011101111a100111001111111000111111111111000111011101101111a1111111101111111001111101111111111212211022202121101020120221211101110011110
1102211201200101011101101001101111a111111111112101121202201022200101222210221111111a1111111111111101110111111101111112221220122021112121212202212212011011100110
1111121112122001211111011010111111a111111111022022101112020011211201102212211111101a0111100111011001111010111111011112022221211102211121011111122110111111111111
0012010221211022210001101111101011a111111111111101212221002122202122211111011101111a1111100111110000111110110111111112201111011021201211121221201122111101111111
1122222211211201011111100111111011a011010111111201110220012122122012020001120111111a1101111111111111111110100111101110210022110220022112110112111122111111111111
1102222111221011011011111011111011a011101110101000212211201211001221021022111101111a1010101101011111000111111111101011222110100212001110222210012112110011010111
1110122010112012111111110101111111a111111110111022112020001122002211102222111111111a1110111011101110111011110111111012222101100102021011202222222121111111111111
1101022120212221111011011011111111a111111111011111212102212212100222112210111111001a1111110010111110101011111110111110010020101122021111012211100121111111111111
1121110121101222211111111111111110a101101011112221122020212021001212000222121110111a1101111101010111101111101111111001121221202121111111021212022111101111101111
1211222111112021111111100010110100a111111101111120121121221222211211112122221011111a1011111011111111111111111111111102000011111222012211221102222101111110101011
1110211121102112011111110111110111a101110111122220201102212212212010222020011110101a1100111111110001011111111011111110211112012221120122202001100122111111101111
1022112222221112001111111101011011a111110111110012221211202001222112121112111111011aaaaaaaaaaaaaaaaaaaaaaaaaaaaaaaaaabaaabbaabbaaaabbaaaaabbbbbbbbbbaaaaaaaaaaaa
1021112202221002011111111111101111aaaaaaaaaaaabaababab1112002011120212201011101110011110011011111111111111111111111111212220211221202010121111220111111111110111
12022000011201122111111101101111111111110111112012020a2220211010201111110112110111111111111111011111111011111111100010221201002121002112222211010121111111110010
01112121022212011111111111111111111111111010121111012a2121112122111202112110111110111111111011001101111111000110111111111211110210022002212111121212111111111111
01110211121222212111111111111111101111011111102020212a2121112201021121210121011111111011111111111011001110010111101011100222211022222221010212111100111110111011
11221212211201202111111111111011111111101011111022122b1111212111112012121211011111111011101111011000111111000111101100221212011022121222202220121220111111111111
11212111020101121011110111111111110011101011102112122a0221112101202011222011111111011111110101110101111110111111110112022211201111122112021102111112111111111111
12221101110120122111111111100011100111111111101122202b1112101111220202202211111101110101111101101101100000110110000111022022112120212200121010121200111101111101
11010101111011111111110111111111100111111101101112221b2221122121110122120212101111100001001101111110111111111111111111111122212121222111212221021110101001111111
11111111101111111101011110111101110011110111101211010a1121211112222221221212101101101100101111111011111111001111001112211101212111112010120222120211111111111110
11111011111111011111111110110111111111111011120122222a2110202202221211212122111110111111110111011111011110111011111110212110121222202011211212000211111101001110
11111011111111100111111101111111011111111011110121222a1011112202221001201211101101111110101011111110111011111110111012212211202022210221022011222221100111010111
11011101111111111110111001001010010011101111012211021b2010221221122211221101101111111111111110111011111111111101111102122121212122020220200221220210221212212012
10101110111010111110110011001110101110110100120122222a2112122201200122102211111111000111101110111110101010101011101110101110110111012122112220021012202210121221
11111111111111111111111011111101001111110110121012021b1010221000221100221222101111111111011110111111111111011110110011011111011101211120111122222221120110112122
11111111111110111111111110100111111101100111120222102a2021112112101111102122111100111011101100111110011111110110111111111011111111002222000200111110122211021022
10111101011111111111011111011101011101111111122201122a1002221200111220220010111101101011111011001100111111111011110101110111111011012221012020112101112101021100
11001111111111111101101111111100111111110111101120212b0101200babbaabbbababbaaaaaaaaaaaaaaaaaaaaaaaaaaaaaaaaaaaaaaaaaaaaaa111101111210212012122222022221022102111
11001111111111111011111110111111111111111001122121122a1202122b2101120022211111111111111111111111111111011001100001111011a001111011101112020122010112201102011221
11111001111111111111110111111101001101111111121212022b1222222a1000222002110210011111111111111110010111101111111011111101a110011111200221212221121011121111111202
11011111000111101110111011111110111001011111111020120b2120211b0212212012120101011111101111111111111110101111001110111111a011110111001012221220211110121211211210
01111111011111111001111111111111111111100110101011011a1111010a1011110111111101110111101111111111110111011111100111111101a011101111122212102122222111112212112002
10111111111111011111011111111111111101111111110101111a1111111a1110111111110011011000111110111011011110111011101110101101a110111101211102111221211112122001121112
11101111111011111110111101111110001100111110111111101a1111001a1111111111110110110110011111101111111111111111111010111011a111111111111102121121112112121112101022
11011011111101110101111111111111111111111101111011111a1111110a1111101111011011011110110111100111111111010011111101100001a101111111110122220111220100211221101001
11101100011111111011111111111111111111111101111111101a0111111a1111100111111111111111101111111110101101101111111100111100a011111011212120110111020112210111212120
11111011111111111101111011101101101101100011011111111a1111011a1110111001011110011011000111111101011111110110101111111011a111111111112220120222210000122102111121
11111010111101110111111111111101001111110001111111110a1101000a0111010111101111011111001100111111101101111111101101001011a111110101212222102211222221012212010212
01111011111110100101110111111111001110111110010111110a1101111a1111110111111001011111111110011011101110011111111111111111a111011100111222212111020100112021122211
11011011111111111111011111111111111110111111111111111a1011110a1111111111011111101111111010111011001110110111111111101111a110111110022222111121102221022010112111
11011111111110111110011101111111000101111110111111101a1011111a1101101111111101100101111001110111101011101111111100010011a111111111002211112102222222122122102112
11111111111111100110111111101101110110111111111110110a1111000a1101010111101111111111111100111100011011111111111101100111a111111111101220221021112010201122201011
11110111011111101100111111001111110101111111111110011a0111000a1111100111011111111111011100011111000110110101111111111010a111111100122120210122221122211122010111
10110000111111111010111111111111111110111011101111111a1110111a0011111101111110111111111111011011110011111111100111111111a011101110221211122020012222210012121221
01111101111001111010001101011111111111111101100011111a1010111a1110111101011011111101111111111100111101110111111111111101a111110111110122211222110120122211122011
11111111011110110111101001011101111101011010110110101a1111111a1111111110101111100111101111011101111111011111011111111110a001101110221121222201220120121212121101
11110100111110111111111111111011111111110111011111111a0111110a1111111111011110101011111101011111111011011111010111111010aaaaaaaaaaababbababaaaabbabbbbbabbbbbbbb
11111011111011111101011111111110111111101111011011110a1111010a11101110111011111101110111111101110101111110110111111110000010001111121111110210211211212211200022
11001111100110111111011011110111011111111100111111110a1110101a11101010011110111101010111110111111011111111111111110111111101111111002110112121101212211110120210
10010111111111111111111101111111110110101101110011111a1111101a01011111110111110111111110111111100010011110100110011111011111101111011112121001222221112022020221
00001111011110111101110110111111111111111111110010110a1111111a11111111111111110111111111111101111111111011111101111111010111111110020122121221221122102222010212