119 8
103 148
100 34
40 108
67 70
78 156
29 122
6 105
15 143
97 49
1111011011111010101111110110101011011011111111011111001101111110111101a11011101011a1111011111110010110111111111110111111aa11110100111111101111111011111101101011
1111111011110111111111111111110110111100110111100011011111111111111111a10111011111a1011111212101111100110102221122210220aa11111111100200210121120111201212220101
1111111101111111011010110111110111111111111101111111111111011001111011a11101111111a0111111112201221112221101111222221011ba11111111111221112221121112121122221101
1111111011111101010111011111101111101110111111010111111101110111111111a11011111110a1111111222222112111212211202011012002ba11011012002002221222111210012100112111
1111101111111111111110111111011111110110101111111011011111001111111111a10101110111a1111111222221221212220112221020102202aa11111121212022111100021111122211222110
0111111100111111111111110111110111111111101011111011101110111011111011a10010110111a1000111211211111101121022210211201020ba11101122011011211122220202120210021120
1011101010111111110111111100011100111011011111101100111110101010111111a11101111110a0101111021201110112211102210201112212aa11111111101210222222112012212112111010
1100111111111011011111011010111010011101011111011101101111111101011110a11111111110a1111110221111212111211012012020010012ba11111112111011012110012210212121112220
1100111011111101111010111111110111101101110001111111101111111010111110a01011011011a1111110211110112112011011122120022210aa11001101221202122211011111202211211101
1101110011111111101110111110011111111101011111111111101111111010111100a11110111011a1111111222122211111222101122221122112aa11111110221022020011021122220221111010
1111001101111011111110101110111111111011110010111110011111111101111101a11111111001a1111100110002221221210021212212220101aa01011122112111201111222111122222221101
1001111110010101111101111011111111101111110111111111111110111000111111a11111111111a1101001212102011122011000211112110210ba11101111122121222222201110222220211021
0111111101111101111111111111011110100111111111001100111111111011011110a00101111001a0101111121222101211200101200022020111aa11100110111202122111122222112221210221
1110110110111111111001111101111111111110001111110110101110000111111111a11111111001a0000111120012010112221012112210222222aa10111122101102021100120210110122210121
1111111111111111101101111011101111111001101101111011111011101100111110a00111111110a1111000121122002021122112221021222021ba11102220202122221012211211202122122210
0000111101111001111111111111111111101100111110101111011111111111110110a11100111101a1111011020022112210201122211222000220ba11120221220222022111101110111022101211
0111111111111111011011101111110110111111111111111111111111110101111111a01101111101a1110100102202121002111212222122211202ba22110222012222221101110122110110111211
1111100010111101111111011011001110011111101011000101111110101011011111a11000111111a1111110022221101120120222222220200112bb01000122200210202101112221111221001221
0111111010011101111111101111111111111101111111011111111110101100101111a01110111011a1101101020222202202101202202222220212bb11111122220220222222102211222111011220
1111111010111111111110101100111110111111010101111100010101110111111100a01100111111a1101101102222021101011111222002212102aa11121122200022120200122111120221102121
1111111111101111111111101100011101100111111111101111001101111111011111a11101111101a1111111011012122121222212222222212022ba20121012122222122111011120111201211111
1111101111111101111011111101111111101100110110111011101000111100011111a01001111010a1111001210221210211012122212010202222ba22212020222202201222111000210112020221
1101111011010011101101111111101111111010110101111100111111111110101101a01111111111a1011011110110111110111012211211112202ab22122122221122121112101212210120102111
1111111111111111111111000011111111111101111111111111111101011011010011a10011111110a1010111000000101011011112222122221220ba12102022020221121111112220122112111011
0010101111110111111111011111111011111111101100110111110111111111111111a11111111111a1111111111001011111110112110122110202ba21110222220110222102010101101111220211
1100101110010111111011111111111111111011011111111111101111111001111111a00101111111a1111111111220012210112022202222200121bb22201022212222222211121210212211022210
0111111110111111111100111111101111111111001111111101111110111111101011a11111111001a1011101100212021022221220222020202022ab02002222220222222112020121102101221121
1011101011100111111111111100111111110011011011011101111111111011111111a10011110101a0110111111211022020220222012022212222ba21002112020101221212121122111212211111
1111111111011110111011011101011111110111111111111011111101101111111011a11111000110a0110111111221112120120200112221221210bb22120222020002220201222221200111110021
0011111110101111111110111011000100111111111111111111111111100111011111a11111111110a1101011011002222212222002222022022122bb02111202222200221021211012200202212121
0111111111110011011111111111000100011101111111111001111011001111111101a00000101001a1001111111212022202101202122202122202ba02120121221222121202012222200211100201
1110111010011111111101100111101111111010111111111111111010110111111111a11101111111a1111110001222212221121222121022020122bb02112221010120111111111101111111011111
0111011101111111111100111111101011101111111101110101111111011111111111a11111011111a1110111011111102120222120202202202222bb12112201101011110011101101111111001111
1011111111101101111011011110110101111111100111111111010111101111110101a11111011101a1111111110121210222211212222120202101ba11121020101212201111011110110101111011
1011111111101111110111011110110111001011111111101101111111111011111111a11111111111a1101111111220120222100002012002022220ab22011212221211001111111110110111111111
1010110001111111111011110011110011011110111011111111101011101111011111a01110111111a0111110111101212221202212222122222122bb01211202110212211111111111111110011101
1101111111101111111110110101111111111111111111111111111111011011011111a10001101111a1010111111020122020111122122222222222ab20122121221122021111011111111111111101
1111101111111011111011111111111001010001111101111111111111110011110110a11111101111a1111111011011112111210201222211122212ab01222222001200201111110111111001011101
1101101111101111111011110011111111111111111110111111110101011011111011a10101110011a1111111111102201201111210221101001122bb21122221021020120111111111101101101111
1110111000101010111111101111101011101111111111111110011101101111101100a11111110111a1101111110211201101211222221212020122bb12111011110201111010111001111111111111
1010111111111101101110010011110101111011111111111111111111110111111111a11011111001a1111001100221112021222102112022202022ba22201120020122010111011111111101010110
1111011100011111111011111110110111111110111101011111100111110111101011a10011111011a1101111111001000211211200020122122220bb22120011212010121111111111111111001101
1101010101101001101111011111000110111111101011110101111111111111011011a11100111111a1111111011212012222222010212212122102bbabaabbaabbabbbabaaa1111111101100010010
1110111111011111111111101001111111111011111111011111110011111110111111a11101111111a1111011111002210220101121220221211021b0220200222121112110a1011110011111111111
1101111011111111111111111011111110111111011111111011111111111011111011a11111101111a1101111001112100021112112222222220222b2212121122112222111a1111111101101110011
1111110100111110101111111111111111110111110111111111011100101110101111a11111111110a1111011011121021212012121222202221121a1121111010111111100a1110111111100110110
1101111111111100110011111111111111111110111110011111011111101101101101a10101111111a1011011111102120121102110122201121101b1021111001111111111a1111111110111111111
1111011111111111111111011101111111011110100011011011111111101010110111a11111111111a1111111111100021222011121111212220210b1201111110111110111a1011111101111011111
0111011111111101111101111010111111111101111011111111111111011011011110a10000111111a1011100111010212002221211201111021222a1100110101110100011a1111011101111001111
1111111111111110110011111111101011111111111101011010111101111111101111a11110111111a0101101010112211122112120121011121011b2010111111111111111a1011111011111111111
1111111110111111111110001001110010111101010111111111110111101101110101a11010111110a1111101101122110212011212211101011122b1121011111011111111a1111101111111111101
1111111011101111010101111110110111111111111011111111110110111110100111a11101111111a1111101111220002012201221211021121111b2121111111111011100a1111100110110111001
1111111110110101010111111111110111011111110011111111111211111111112220a22202201011a0101111101201110011011100102011110120a2121110110101101101a1101101110111100101
1111110111111111101101111110111111011110111111111111111111011122112110a20112220120a2210110110101212112111112212110001000b1211111111111111101a1111111111111101101
1111111101110111111110111101110101110011101100111101101202120212111122a22222222010b1221101111210021210021012122111021000a2001111111111111110a1101111111100101110
1111101111111111010111110011011011111111101111111011111222021212221022a00111121120b2201110111120111122221001112212211222b0211111010101111111a1111101111001111110
0111101110011111111111111111101010100111011111101111111012210211120121b12211022121a1221111111010111111111110101111110110a1110111111111101011a1111111011111111110
1111111001011111011101100111110011111011111101011101111111011100111112b01011121002a2211111111111110111110110111111111101a1111111101111111110a1011101101111101111
1111111000111011111111111101011011111111111101011101111201212010222020b11211021220b1020111111111111111111111011001101111a0101111110111111111a0100111111100110111
0100111011111011111100011011111011101101011110111111011220111221220211a00011120022a2121101101111111111011011010111111100a1111111111110111111a0011100111111111111
aaaaaaaaaaaaaaaaaaaaaaaaaaaaaaaa11111111111111001111111222010101021010b21222202112b1111111111001011111111110101111110111a1111110111111111111a1011011110110111011
1111011111110011101111011011111a10111111111111111111111111022222222110b11221011211a1211100111100111011111111111111011011a1111011011110111111aaaaaaaaaaaaaaaaaaaa
1110111111101001101010101111111a11111001111111010111111111012220122222b21200112221a0121100011111111111110111111111111010a101111111111111111110111101111111110110
0110011111011111111011111101011a11111111011110111101011221112110101010b10121211211b0110111101111111101101111111111111110a001011110111111111112121111010220210112
1110111111011110011111111111110a11111111000111011101111202201112112102b11122210020b2111111100011111111100101111101110111a111111010010111111110111110021100222211
1011101001111111111111111011101a01110111111111111111010011112212202121b11112120110a0011100111111011111111110111111101111a101111111111111110102010121011101211211
1111111100111111111111110101111a10111110111111111111011222001110220220a12221111220a2201111111110110111111111110011111111a111111110111111001112112021102111011001
1001111111111011110011111111001a11110011011110111110111210101201022112a12022221222a2121011111110111111101111110111111111a110011111111110111011222122201112222120
1010111111111111111101101111111a11101011101101011111000212210212210022a10100210001b2121111101101111111011110011011110011a100101111111110111110121222112112221022
1011111011100111111111111110111a11010001101101111110110221101111112012b02122221200b0111111111111011010101110110111111101a101111111111110111010102211122222212001
1101111111111111101101111101101a11111111111111101110101001012021102111a02222110201b0111111111110111100111110100111111110a111111100111111111111122111122221001111
1110010011111111111111111111111a11110111111101101111111222212021122120b21012101021a0121101101111111111011011111111111101a111111111100111111101220212221101222112
1011111111111111110110111111111a11110111011111111111101122121122111102a12101222120b2101111001111111010011011011101111001a111111111111111011011221220120020211121
1100111111110110011111101011111a11111110001010111111111112021222012011a11120221211b2111111111111111101111110111101101111a011101111101110111110200211202221111201
0111110111010011111011101011011a01011011111111110111111001222112122220b02100122222b2211111111100111101101111101000111001a111111101111101111110202212210202210010
0111111011111111111111111111110a01111101110011110111111212212222111211b12212221121b1111110111100011111111111111100011111a111101111010111111011212122012120222212
1111011111111111101101111011111a10111111011110111111101112001211221221b10112111100b1101111111110110111101101101111001111a111110111110101111112011120121102020212
1010111111111111110111111111111a11101010101111111010100000112221101202b12121120222a2021011101001110111110111011111111111a101111101111111000111220120212101022021
1111111111111101111111101111111a11111010111111111011111220011111120210b21100121121a0211110011011111101101111101111001111a101111111111101010101221212120220222020
1111111100001101110111110011100aaaaaaaaaaaaaaaaaaaaaaaaababbbabaaaabbbb22120201012a1211110101011111110111111111110111101a111110001111111010101211122000121122221
11111aaaaaaaaaaaaaaaaaaaa110100011110111111111111111111112212201111112001012122220b1001111010111111010001110111110011111a110011011101110101112222211020101022210
11101a111111011110111111a110001110110111011111111110111122020221200112011022000200a2011111010111111111101110111111111111a101111111101111111111200002211212120200
00111a111101011111011111a111110111110100121100211011222122202122112210121221202022b1211111001111111111111111101111011011a111110111111111011001220021122011110112
00100a101011011111111110a111011100200221002222212122201112122110111110101001111111a0110011011111111111111111111101011111a111011111101010111112211110102220222112
10111a110111011111111111a111111011121102111110111121221122012222210101111101111111a1111111111111111111110011111111011001a011111100111111111112012001111122222212
11111a100111111111111022b110210202212010102012122002022211210001001111111110011111a1111111110011111000111011101101111111a111111111101111111112212102010202022111
01111a101100111111122211a122120110202010220200222011011100122122011101111111111111a1101111111111011101011011111010111111a111011111001110101111211110221011112002
11110a101111101111120101b111200111220211210022222222111201011112111011111011111101a1111101101111111111101111011101111001a011111111100010111101121212012120211101
11111a111110111101122222a201211112222221112222200200121212112222211111111111111111a0101101110111111010011111111111010101a111111111101111101112120121211210011111
01011a110111111111122021a210112012102121221022222220200121212112111011111111111111a0110101101111111111111111011111111110a101111111110111111112222120110011212202
11111a101110110111110121b122221201020202222220212202221111001221010111011101110111a1111111111110111111111101001111111111a111111111110110111111012112011021112010
11110a001111011011121021a211111022021220212211222000010221202212011011111011111011a1111111111110111011101101111110111101aaaaaaaaaaaaaaaaaaaaaabbbbabbbbbababbbaa
10110a110111100010102221b200210022200002002222222220201211212201111011011111100110a10011101111111011111111100111110011111001101111111011111112120201202222022212
11111a111011111111101121a122122011210120022212221011111021220201211111110011110111a11111101111111011110001011110111011011111110111111110111112121221022201121210
11111a011111111111110112a122011110110222020122202211200200110210111111110110011111a11111111111101101101110111100111110111011111110101111111101000110110100111101
11111a111111110111112102a102122211202202200122120021222221112020011111111101111011a11100111101011111011011111111011101111111111001011111110111010110111111111101
10111a111101111111102012a222022000201222210200212112021112221121201101101101101111a11111110111000101011111111101111011111111111111001111011011111111110011111111
11101a111101110110011112a111112100211122200222220201122220100122101011101111111101a11110110110110111010001000011111111111011111111101011111111111111111011111011
01111a011111111011102121b211210122220112222222001212221122221222111111001111111111a11111100011101110011111100111011111101010011011111101111011110111111111110011
11110a101111110101100211a010102211022222122121202222101211021221211111101101111011a01111101001111111001111111101110111111101011011111111111101111111011111011111
11011a011101111010001102a222122122021221122aabbbbbaaaaaaababbbabbaaaaaaaaaaaaaaaaaa11111011111101111111111100111001111111111111101111111110011100011011101111011
11011a110111111011021222b222111211022212202b02022222102100201111201011001011100110111111111111111111111110110111111101100011111111111111111011011110111111111100
01111a011111101111120212a112120111212110202b02101212221122002212211111011011110111111111111111111110111111011101111111110110000111111011110110111110111110010011
01111a110111111111102120b001020121222222200b22220002020122121122011111101101111110011101110111111101111101111111110111111111111111111111111010111101111110111110
11010a100111111011122111b112012201202220111a20122201111202001200210111110111111111111101111111111111111110111111111111101111101111010111111111111111111011010011
10111a111111100111112122b122102110120222022b12021211122221121012001100010111111000111111101110011110111111111001111111011011110111101111111101111011101101111011
01011a111110111111022110b210211122202000222b20222020122021110112111101111111111101010011111100111111111110011111110111111000111011111111111111101111111111111010
11011a111101001110011200b101110121222220202b10022120112202020102211111111111010100101111111111011010101011011101011111011111111111111111101011111110011111101011
10111a111110111111110112a122012020022212212b22220112021202211220111111111111111110110100111010111111111101110011111111111111111011111111111111111111011101111011
11100a111110111111101212b121122220222202220b21210222110112212211211100110111111111101111111010111011010011110110101111111011000111110111111111011111011111111111
11100a110110010111111011b110220201002121121b01222121011211012002111111110111111111111100111001111111111001111111111101111110001011111011101111111101010111011110
10100a111111101110122111b222212110012222002b02012201112011201012211111111011011101111110101110111111011110011111111011111111011100111111111110011111001101010110
11110a101010111011102012b212002021210222220b22002212002010121121111101111110110001011111100111111110111111011111011111011101001111110011100101110110100111101100
11111a011111111001021201b111010121112012202a22210001101111111111110011110111111111111111111111110111111110111101111111111101011110111011111011111111101011111111
10011a011101111101121221a021122202011111110b01020111111111101111101111111010111111111011111100111111101111111111011011111111110111101111111101101011111111100111
11111a111111111011120111b111222112000212211a12220101001110101111111011011111111110111111011011001110011111110011110110111111001110101011010101001110111011101111
11011a111111001011011011a111111110111000011a11111111110111011001101110110110110111111011111001110111111111111111110111111111111111111011010111011101111111111111
00111a110111111101010010a110101110111111111a11010101100111011110111011101110110111111111011111100111011101011101111111011101010110101100101110101111101111110111
11111a011111011101100011a011100111111101110a11111111011001110111001110101001111011111111111111010011011101110111111100101111111111111111111101101111111111011111
11011a011011111111110011aaaaaaaaaaaaaaaaaaaa11111110101111111001010111110111011111111110101111111111110011100111111111111011100111111111010111101111111010010111