115 142
6 1
83 68
15 73
63 94
82 40
22 69
59 11
98 100
69 15
1101111111111101111110111011010010111001011111100110100111111111001101111111111a10011111101111111110111111111111101111111111011001111111111111111111101110111110
1111110111010111111111111110111111111100101111111101111111100122122201221110010a11012222211111011111101111111111101110011101111111011111111110111101111111110110
0011101111110111110111011111111111101110111110111111111011002121210112220211122b11222122111111111101111101110011111110110001110111101111111111111111011001101101
1111010111111111111111111111110111101111011111010101111111010212001111102121221b12121221111111110101011111110111010110111111111101010111101aaaaaaaaaaaaaaaaaaaaa
1101111111100101110101100101001111111111111111101101111011202102221122212102011a11222220211111111111111110111100101010101011101111010111111a11111111100101111111
0111110111011101010011101111111111111111111101111101111101111220012112122111212b01021111211110111111011111101100111111111011110001110111111a11111011111101011111
1111011101111111110111101111111101111111101000111000111111210122122020212221121b02111201001111101111101011101110010110111100100111111111101a11110101111100111111
1011111111111011111111111110101101110111111111111100111210012222121202220220000b11012221211110111010111100110111001011110111111111111101111a11111011011111111110
1100111111111001111100111111111111111111111111000011001221012022222221222222222b21012111111111111111101001110111110011101100111011111111111a11011011101010111111
1101111101111101111111111011111111110101011010110111111102012201122210220121202b02212112100111101101101011111111001011111011111101111101111a11111101111110001110
1010100111011111110001111110011111101110011111011111111201222222201220222220122b22222112111110111111111101110111111101111011111111110011110a01111111100101110101
1111111111110111111111011111101110111011110111101011100221021022102222222200222b02121212211011101110111001111111111111011110110111001111110a11011111111111111101
0111110101011001111101110010011101111111110111111001101122222212220220202202222b21122220210011000111111111111111110001111011101111011111101a00001111111101111111
1101111111111011111111110101111111011101001111100111012120202220022221020012202a12110111200111111011111111111000011111001111110111111111111a10111111111111011110
1001111111111111111111101000111111111101111111100011111120201022202122222022222b22112022201101101111110110011111110111111111111111111111111a11011011111101111011
1110111111111101101111001111111111111011111101111101111202212200122202022212222b22222212200111111110111100011110111111011011110111001110111a11111101111110111111
0110111111111111111111101011111110111111111000010011112211202021212202122212201b22122110010111111101110111101101111111111011111111110111101a11111101100101100110
1111111110111111011101110111111111111111111101111111112112220102222222222020202b22022111211001110110011111111011111101111011111100001001111a11010111110111111111
1111111101110101011111101111111011110010011111111111112021222121212222221211102b02000122211101111111111111111111011110011001111111111001111a00011110111111101111
1011111111011011001100101110011111111111110111111101112212200122221010112222222b20112211011011111111111101111011111110111111111010001011101a11101110111111111111
0101011101110001011101100011011010011011011111110111102120101202220012222220200b02012012001101011011111110111100111011011011101111110011011a00111101011011111111
0110101111011111110111111101111111101011111111101111011200222222220222222002111a02220211011111101111111111101111111111011111111011101110110a11111111111111101111
aaaaaaaaaaaaaaaaaaaaaaaaaaaaaaaaaaaaaaaaaaaaaaaaaaaaaaaaabbbbabbbbbabbbbbbbbbaab2022222011101111111111111110101111010111aaaaaaaaaaaaaaaaaaaa01111111111111001011
011101101111111010101101101111011111101111011111111101221200220222122121222110122221221201111111111101001111111110011011a111111111011111011011111111011011110111
111111011111111101101110111111111111101111011111110111211002212221200222202112221200222221111111111111111110111111011111a101111110101111011111111111111111101101
111100111011110111111111111011111111111100111100111011012222222222012212221022222222202111101011110011111001110111111101a111101111111111110011111110001110110101
111111111111111111100011111111011111111111111011101010200122111122012022122012202202202110000111111101111111111111110111a001111100111111111001111111101111100101
111111110111111110011101111011110111011011110110110111111112212010200212212002021222220221111011100111111011111111111111a111111111111111111110111111111101001110
101011111011110101111111111100001111011110110111011111111212222220200222202201212212221111001111011101001111111010110111a111101111111011111110011111111011111111
101111111111111110110111110011110111111111110110111101212120212121022222022222112121201121111011111111101110111011011110a011111101111101011111111110101011111101
000010111011101101111010111010011111111111111101111111101110221102222220202022212012112211111011111111110110111111011101a001111010101111011111011111111111111110
111011111011011110111110110111110100110101111111111111211011202022011001210110212112110010011101111101111110011111011111a110111111111111111101110101110101111101
110111111111111111011111111111011111111111110101110011121021221102120120202111012011111111111111001111111111111110110011a111111101011111101111111010111111001111
111011011011101101111111111101111000101111111011101111111012212121200211210222010101201111111111111101101101111111111011a111111011101001111011011111111011111110
011111100111111111001111111111010111111100111111110011112111211220211112102012221122000011111111111111111101111111011111a111101110011000110111111111111011011101
111011011111010010101110011010111111101011111110111110211212211121110101112211111102001111110101111111110111111101011111a101110111101111011001010101110111111111
110010101110111110101110111101110110111111111110100111120111111010201110122220212121011010011111001111110111110011111011a111111110011011110111011110111101111111
111111101011111011100101111111111111100011111111011111112221212122220212212010011012110011111111010111011110101110110111a100101011111011101111111110111111111111
111111111110111111001111110110111101111111011111001110001111111110110111011111111111111011111101111110111110101101111110a011110111011101110111111011111111101110
110111110111011111111001111111101011111110111001111111110111111110011111011010111111110010111110110010111110111111111100a001111101111111110110101101100011101011
111111101101111111110111111111111101011111111101110111110111111011110111111111110001101111011111111110100111001111111101a111111110110111011111111001110011110011
011011111111111100101001111111111110101110111110111111111101110001110011101111110111011011111011011101100111111011101111a011111111111111111111111101111111011001
111111111111011111111110111111111110111111110111101011111111101101101111111111010111101111110010111111111101111101111111a111010110110111111101111101111101111101
101100111010111011101111111111110011111101111001110111111101011101101110101101111111101111111010110110001011100011011101a111111110110111111111101011101011110001
112202012112211101121211111111110110111111000100110011101111110101111110001110111101111101100111111011111001011111111011a101010101111101110110101111111110100100
011122221210221110111221220101011011111111111111110111100111111111111100101110111111111100011111111001011111111011111100a111011111111110111110010010111110011101
001021211011200010121221002011100101110111111111110111111111100111111101001100111011110111111110011111111111101111111001a110101110011110111111111111111011111000
110112011001212111202000222111001111111100111111011111111111111111111111111111101111001110000011111011111111001110011111a101111101111101011110110111011111111111
122020121110211012021220122111101011010110101111111111101010111110001110111111011110221211221222221120202100221111111111a011111110101111001011101111111011111111
122122121122212101211212111111101111111111011111111011101111010111111111111100120222222211021221222200112211220110111111a111011110110011010101111101110111101101
121202111222202222112101122101101111011111110110011111110111111111110111101011102101222201120212112122122122211111110011a110111100001111111111100110101111101111
021021111111102122102212122111111110100111011111111110111101110111111010011101102120112011122111220121122001211111011111a011111101110111111110101101111110111101
122222212210112101212222110111010111011111001111111011111111111101001101111111122220122210011102121021200212121001111011a011100111111110101111111001111111111111
122112211102222112122122012110110011011111111111100111011111111111111111111011112122120222220012002100112122010111101111a111110111111101111011111111111111110011
102112202012212122212012002201211111110110111111110111111111011101111011111001111110001202021020212121220222200011111111a001111111110111110001111111101011110011
121200222022212220022002222201210110010100110111011101110100111101101111111111122020112110021221012221210220111101111111a111111111010011111111101111101111111111
122222221002222222222220201221111111111110011110111111001001111101111110101011112110212110220112222211101121221101101110a101111101111111111111111010101110011111
112212010222022112200221122212111111011110001111111011110110110111111101110011021212012021211122202021122110211011000110a111111001010111001111111010111111110101
120022020002222222202011102222211111111110101111111111101110011111111111011111121121221012222122201022211200101101111010a011001101110111011010111111101111010001
002120122102101012220020122212011011011111101111010111101011111111101011111010010101120101212222021110012022101100100111a111110001101011101110111111110111111111
121012222211201212220101010202111111111101110110111110010101111011111111100111021211201000222021222121201012201011100110a010111111100111111101011110111001111011
121222221212102220122012222200011111101101110111111111110111101110110011111111120222120012220001211222212110211111100111aaaaaaaaaaaaaaaaaaaaaaaaaaaaaaaaaaaaaaaa
0212122022210222222020121220102011111011110101111111111100100111111011011111111011111022101212202222011211211211111111110011001101101011111110111111111111111111
1222122212222221021021222220201111111111111111100111111110111011111111111110001221201221200222122222020120001111111111101011101111111011110111111111011111011111
1212120222210222011111111212212011111110111011111111110011110111011111111111111102102211122211022100222022220111001100111010011111111101110011111111101111011111
1122010222021220100112221122222111111111101111011111110111101011111111111010111111201120022202121120202200110211111101001111011111110111101011011110111101101111
1222222202102122012102221121222101011110111111111111111011011011010110111100111211111220001111122110200120120110110111111111111111101101110101111111110111101011
1122202112120222022222212121212222012012120220111122020110111110101001111001111212110102212112100121111212111110111111110101110111111111111001111110111111111100
1020022021222222201222221221212012002112221211111111220211102022210221102011102002220210020111202002111210112001001011110111111011111110111011111111111110111101
1210220122022021202202222222200102202002111121110021022211102221120000002101210122221022222011202010212201101211011101101101111101111011101111101011011110101111
1100122211021202111120212022200002212012121021102221120022222202211212211211121222112002222112012222111221010211011011111101100111111111101101011111111111011111
0222202110222122022122111202222122120111220001100222222122212211201211200201221000220111112222222101112211101210111110011111111011111111011111001111111111110110
aabababbabbbbabaabababbbbabbbbbababbaaaabababbbbaababbbbabbaaaaaaaabbabaabbabaabbbbbaaabaabbabbaaababbaaaaaabaaaaaaaaaaaaaaaaaaaaaaaaaaaaaaaaaaaaaaaaaaaaaaaaaaa
1122222101002122222200122200211102212121111112122111212221122120122002010001201201220122210122112011200110211211101111101110111111110110011111000111100111111101
1222212212220112121112221221011211222121220122101101212212101112211122102222011000221202111212122220020210222110111111010101111011111110011101111111111011001111
1111120222111222201202111220221001211111112112121021222010002122110210112222100002221222110221122011110222101211011010001111011111011111011011111111110111011111
1210111110102012120201122202222101210112212222220211220212111221221012121021222211100112101202212001022022111201111111111111101111011111101101100011110101101111
0102202212122212112002210222000102121112222221222020100221011012211002122022102122200100001210121222212102222210011111111101100111111011011111111110100011111111
1202122220211020201121212112211120112122111210110222120101111011022021022222220021201011210102122211012122110111110111111111111101111110011111011111010111011111
1212110222120022112211221220022002211102020100121121201121220211201212121202010101101111101101011100111011100011111111111111111110110110101110111110111101111100
0222110121110211111111121220122222111110212122102200122021210221021021112121222012201101111100111111010010111111101111011010100111111111111101110110111010111111
1011022120121112221120021022222102122111201112221100221221112120121211212212121112110111111111011111011111011111101001111111111111110111100111111001101111111001
0010212201012121022112102202211120210200211110002011102210221122112221121012102122211111111110011011001101111111111011110111111111011111011111011111101101111010
1121012210121212022011001221121111222122202121121210110211112220220021122221110210120201220012201111012220101202000211110110011011010111111111111111100110011111
1202122120111121120212222200211222121111220211012122212202121101121120211202222121220121211202110222010012200222112011101111111111110011111110101111110111111011
1111111101110111111111100212122121022112121102002110222221101202201002002221022012101022012212022021222222110111201211101111111111110101101101100001111110111011
1111011100111011111111111212211110022212002210111221111200210200121201022122101122201222122202201212201102111210220210011100100000101110111111011111101100101111
0000111110110111111111001211122021121022121111001101022021212121200121122221201120021211010110012111202222222120002110111101111111011110011111011110111101111110
1111111111111111101011101102120212112122102222211210121110102220112101200010100121220202222021110220211012220121120110110111111110101111111111011101101111111111
0111111111011111011111110120112112020211210121101211210212200211111120122120021112000121122202212121101121120002000111111110111100110111110110011111110110011101
1111111111111101111010100022200211221222012120112210102020121111111112022102112221221112110102222022111202102121122011011111011111110001101010111111111101100101
0011111111101111111101101012101020011112222112211122221102222011110121122120200101211221212221021002022121021222201210001010111100111011001110111111011011110111
1111100111111101111111111110212200202101120202110102220020211021011211121022101121121212112101202211002222101122121201111111011111111110101111111011010011111111
1110111010111111101110111111211122112112212122112020221222121011021122211102021222211121122222110112110212201102121211111011111111111111111111101111011101110010
1110110110111111101011111211212120021122220222101212210001120012122211012110111222021112202021110201111011210120120111110111111111101101011011111010111101111101
1001111011111111101111111112012120102211122202212112221202102120110011011112211212220002220120100211211122221012221100111111111110111111100001110111111111101111
1111111110101111110110011202000212122221021121222011220222201121121212100201102020221212120212111221212100121212202010101101111111101111011111111111101111111111
0111111111101110111101111210121121202120112021011111112212220211002012201002120121011122122211211101121122110112000210101111110001111111111111111111101111111101
1111111111111001101101001111100111111111011001011111122111220011122111222202212101121221222122112011112112102112120111111111111111111111100111111011111111001111
1111101101100111111111110110011110101101111101111111111111111111010101111100011111011111111120120121021220212010120210110111111110111110111111011111010111111111
10101111111111101010111111111111110110111011001100aaaaaaaaaaaaaaaaaaaaaaaaaaaaaaaaaaaabbaababaaabaabbbaaaaabbbbbaaabaaaaaaaaaaaaaa111111011111111110101011111101
11001111010010111110111011101111111110111111011101a111111111111111111111010111110111110112221221200210121102212111111101111101111a101111111110111001110111011111
10110111110111111011111111101111111111111101111110a101001111011011000111111111010111121020200111101112112011110222121111111111110a011011111110111000111111111101
10111011011111100001111110111111111110000001110111a111111110101111111111111111001011001221221212102122221212211202201101110100010a111011101101101111111110111001
11111101011110101111111011111111111111111111111111a001110101110111110111011101101111112201211102222012012111210221011111110101011a100111001111111011110011101111
11111111011010110111110011110011101010000011101011a110110011110111110111111111001111122002201022122222211222210212211111111110111a111001011111111101011101111110
11111110111011111111111111110111011010111111011101a111100111110111011111101110111011112210112112022122122101020201020111011111111a111111011111111111111101111101
11011111001110111110101111111111111011111111110111a101111111011101100111111110101111011101022222212121220221221022021111011010001a101101111111111100101111101110
11011111110100111111101101111111011011111110111101a011111011101110110111111110011111101221222202122101121110212201221011111110111a111110110111110111111111101111
11110111111011011111011011111110111101111110101111a011010111010011111111111110011110121222212012220121222121122122101111111100111a111110111111011011101101101111
10000111110100110110010101111111001110111100111001a111111100111111100111111011101011121220111110221212012120222122211111110111011a110111111011111111111010001011
11011011001011110111101100111011111111100110111111a011100111110111110111110011011111102221221011222221112110221112211010101111111a101101111110101111110110111011
11100111111011111111111101111010111111010110111111a111111010011110111110111111011111110111120111221011112222101020210111010111111a111111111111111011111011011011
10110100111111101111100111111111101011111011111111a111101010101100110101101111111111110212222120121112011222002012211101111100101a111100011010111110010111001001
10010111111110001111110100110111111101111111111010a111110111111111111001011111100100110111010111111100111111111011111110111111111a101101111101111111011011011111
11110111111100111110111101110111010110010010111011a101111111110011010110111111111111110111010011111101011111101101110111111100111a111111110101111111101101111111
10111111111100101011011111111111111001111111100010a100101011111111111111111111110110111111111111111111111111111101111100111001101a101110101100110111111111111111
11111111110101001111110111111111111011011111111111a111000111000111101111110111010111001011111111001011111101111101111001011111111a111101111101011011111110111111
11111110101111111111010001110111011111111111100101a111110111111011111111111111111110111111111111001111110110110111001010111111101a111010111011111111111101001101
11111110110011111110101101110111111111111111111111a111100011101111110111111010111011110111110111111111111111111111011111111111111a111111100001110110111111111111