102 11
3 150
40 132
42 128
33 92
21 101
28 36
93 71
28 114
119 55
111110111111111101111111111111111111a11101111011110001111111111111101110110110110111111111011101111111011101111111101001111111110a110101a11011011101101101011101
111111111111110010111110001111111011a11111011011111111111111111111111111011111111011111101111111101001110111111111110111110011101a111011a11111111110101111111001
111011111111111111001011111110010011a11011100101111111101110111111011111011111111001111111110111111011111111111111111111111011111a011111a11111111110101111111111
110111111111111111111111011111101100a11011111111111100110111111111011110111110111111111100111011111111111111111111111111101110111a011101a11110110111111110001111
111111111011111111110111111110110111a11111111011111110111110111011011011101110111111111010011111101111110101111111110111101011111a101011a11110101111111111111111
101110001111111011111111101011101101a01010111110011101001111111101111111111111111101111111001011111101011110001111111111111111011a111110a11110111111111011111111
111111110111000110111011110111110111a11111111111101111111110101111111100101111000111112101011100021001121012112221122101111110011a110111a11101111111011111111110
111011100101101101110101110111011111a10111111111111111111111110100111110101111101101112220221211111012020101102220022111101101101a110101a11111111100111110111111
111111111111110110111111111111111111a01011111110101000011111111111111111111111111101110221211112022012211112122002101010100111111a110101a11101101110111101111101
111111011001111111111011111111001101a01111101101111001111101111101011111000110111101102221221111000100202220112121202111000111111a111111a01111111111111110101111
111111111111111111110111011111110011a01011101111101111001111001110011111011110111101012221202111000121102221022112221011111101111a111111a11110001111010111011111
101101111101111111111110011111111111a11101101011111110111001111111111111011111111111111120220022110222201212121011111111110010111a111111a10111100111010101111111
110011110111111001110111111001111111a11010111101101110111011111111101111111111101101111021110221221112021122200111112111111111010a011111a11100001101011111111111
111111101111110111110220102101101112a10120222201220211111100111111111111100111101110002110120221122220111221122212012211202122122a001110a10011011110110110000111
111111110111101110110220011111122202b22211222211011011101111111111011111101111111111110121221211121212220220202221222201102022221b111110a01111010111101111110111
011111001010111111111110021210100120b10011011020102111010011111010111110111000011011111222222020012212222201222000210110212121120b011001a11111111111111111111111
111101111111101111111211211212112211a12222201021210210101110110110110111101010111111102211220022111121211222121210202122122221020a101111a11111110111101110100101
101111111111111111111112211011212111b12111221201110211111001101111011111101011111110112120222010211201220022021222201121210012212a101111a01111111010110111110011
110111110111011110111111221222020110b02112222122121111110101111011111111111012011212210222122120122212220002220222212222222020022b111111a11000110111110111111011
001101111101101111111211121000221212b11200021122112101111001010111111101011112020221111222000101120222221202201222120212211021101a010111a01111101111110111110111
110011111111110111111121202211012220b22121122102221001110101101111101011111112212121022210212222202200222221201221122111100221112b011110a11101101111111010111011
111111111110110101111022120112101100b12121222011120101001011111111110011101101122202122221222021200222222202212002202222111220221a111101a11011101011111111111111
101111011111110111111122020122202122b12121201112212201110111100011110011111111211222112221200220022221220202221222222111120121200a010101a11011111101111110011111
101110010111011001111111101112122202a00022211111222110011110101100011110101112221210110212222212122221222120002022202121000222111a110111a01101111110110110111111
111110111111111100111222100112210122b02212110122221010101111111110001111111012221202012222222222020212222220002012202212101011221b011011a11101111011111111111010
010111110111111101111222022022211222b11201021101212010111001101001111111001012122221101212012212022222222202222200221101111220212a022221a11112201212111101010111
111110111111011110101011011122220020b12211220212211110101111111011110111111012122110120122120022001021020002121201212200202122200b120210b12122120122111110101110
101101101101111010111020111111121111b12202001201102001111111011111011110001111001200102022202212222220022222202111002222122201222b222221a21121200212111111111111
111110111011110011100012022121210111b12122222021101201111111011110101011111102120111122222222122021100022220222202200212222120102b201020b01111221121101010101111
111011101110111011110001021121002121b10211111222010210111111011111111111101102222121120220222222122120220000222222222122122222222b202200b20222221022111111100111
110111111111111111101212111012111201b11210100221012011111111101111011111111112111122222122202210200222222222122022212221201221122b022200b12210222021101111111111
111101111110001011011001212210112111b21001221111110211101011110101111111111112210022012102200201112222222222221212222222002220222a222121b20222202211111111101111
111111111111011111101120101112212120b11222122221220201110011100111111011011111211212120211020201222102222201222122222222222100202b120202b22122010022111111101111
011100110111111101011121012001112212b00121112001011001111001111110110010011102202022112212220102201200022222221022201222122022222b220220b20220222122101011111110
111111111101110101111220202210021202b11212211122212101101111111101011111111111201201212122201222122220222222102022222121222102122a102222b01202201221111111111011
011101111111111111111121222122221110b21021122211001111011111011101111110111012101112222222220210222222211012002222222020222022020b210212a22222210012011111111111
011111101111111111111010111221211102a01121112122202211111010101101111110111012202022111101212200222012222120222102220102220220222b220012b22202122221101111101111
111001111111110101101110211221201211a22222111201211110111101110111101001111010222101021121010101102212220021212202222022210022102b120222b22112221111011111111101
111111111111111011110001200211200211b02220010122222211111111010111011110101110212111222200211121121222222202010222201222222220220b102222b22222221121011111111111
100110101110111110011011012212222110a10220212101222010110100111111111101110112112122100122212211011222212201001101221200202202020b222120b12202220002111111111101
001111110011010101110012220012121221a10221222021022200101110111011111111011112110211121222111101120212222201221200201022122222222b202222b21102121112101011011111
111011110101001101101211202212101220a21222102022112211111111011111101111111012212112122202111211120222212202011120022222222222202b202221b02122112112011010011110
100101010011111111001112220202112222b01222111122110111101110111111111111111002100120102111112102210011222222002210202222222222220b121221a20122121221101110111010
111111101010111111111200220200111021a22111112020202211011111011101111111011112211210122101022022211202222200202122220221002002221b020222b02222211111101101111111
111101001111111111101011010111011111a11101100110101110101111110111111111111111000212021212120101002201211212011112001222120202122b021022b02212121212101011111110
111111111101111101111100101111110001a11111101111011100111111110110110111111012211121111110112122202110002102111100212222221221222b201122b22220211221011111110111
111111101111110110110011111111111101a11111011111110111101111110101110110111112211220101222212201202100220210001101222120212211212b212000b22222222222111111010101
101111000101111111011101111111111111a10111101011100111111111101001111110001011111022201021020101112221020101111112221222020112222b202210a22211210102111110111111
111110111110111111110011011111111111a11100111111011011011111010111111011110110212212212112121102122112111211111110021220202220202a222120b21102222022111111111111
011111111111110011011110011111111111a11111101111111100111111111111111011111111111110101111111100011010000011110111100022022122221b220202b22221021221110111101111
111111101101111110111111110111111011a11111011010110111111001111111100000111111101101111111111111110010110111111102212220022212212a202222a22022221111101111111111
111111101101011110010011110111111110a11110011111010011101111111111101101111111101000011011111110110110111111100002122120222221010a012022a11202212211011110111111
111111111011111111111111101111111011a11111101101110111110111001111010001110010110111111101101100111111111011011111212220122220202b020022b10210222200111001111111
110111111111111110011101111111111111a01111101111011111111111110011111010111111111111011111001111011101111001001112122220220222120b000212b01222222201101100111111
101110111101111011011110111011101011a11111111111111101111011111110111011010111111011011111011111111011011101111111021222220212210b022212b22221221012000111111111
111110111111111111111110110110011101a01111011001111010110111100011110111000111011101111111001111110111111110111112012122000222201b221011a20222222221100110110111
011111111111111111011111111110011111a11101000001111011111111001011101111101111110110011111111111011110111111111012210221202011121a121102b12111010111111110111111
011101111111111111100111111111010011a10001101100110111011111111011111111111001011111111111111111111111110111111111121111210211011a102222a11101110011110101111110
101111111110111101101111111110100111a11111101101110111111111010111111111111101110111111001111011111111111111110111100101101011111a100111a11101111011111111110111
111101111101100110111111111011101111a11011011111111111110101111011111010111101001111101111111101110011111111111100111110111111111a111111a01111111111110110001111
111110111001011111111011111011111110a11111111111101101111111111111111011111111011111010111011101111011011111111111110101111101111a111111a11111111111111100011111
100111111110111111111111111110111011a11011110111101111111111110111111111111111111111011111110111110111110011111110011110101111111a101111a01111111111111101111011
111111111111111110101111110111111111a10111111110111011110111011001101010110111101101110111011101110000111100111110101101110111110a111111a11111110111111101110100
101111111111010110101111011111011111a11101111111111111110001101111011110010011111111111101110111110011110111100011111111101011011a111111a11110011111010111010111
111111111100111110111011011111110111a11111111101110111101111111101111110011001110111111101111110110011111110011110111101111111011a110110a11110110011110111111111
111111011011111111011111111111111110a01111111011101101111100111111101111110111110010111100110111111111111111111011111111110110111a110001a10111111101011111010110
110001011011110111111011111101111111a10111111111011110100111110110101111111111011111111011011111110011111100001101111101111101110a011101a11111110101111111110101
111101111111111101111111101111111111a11101111111011111101011111111100111111101011111111111111011111111001111011111010111111111101a111011a11111100111111011111111
111100011011111110111111011111111101a11110101111010111101111101111010011111100011101011111101111111101111111101101111001101111011a011111a11111111110101011101111
111101111110111011101111111110110111a11101110111111111111111010111010110111101111111111111101101110011101111011111111111100011101a111111a11111100111011011111111
111101101111101111110110101111111111a11011111111011111110111101111111111111111111111011111111111111111111011101101011111011111101a110111a11111111101111111110101
111110111110111111001111111110111011a10111111111110100111111111111011111111111111101011111111110111111111111111110111111111010111a011100a01111111101111000101111
111111110101111111111110110110000111a11011110111111110101111111111111111111111001111111011111111000111111111111011111111101111011a111111a01111101100111100011111
011000111011111100101110111011110111a01111101101111111111111110111100011010111110111111111011001010101111111011111111111111110101a111011a01111111111100111011010
101111011110011100110111111110111111a11001111111100110111011111111111101101111111010111101000111111111111111011111111010111011110a111111a11111011110110111011111
111111001111001110001101111111111010a11111110101111101101111110011111111111101101011011111111111111011110111110110001110110111111a110111a11111111110111111111110
111111101001011100101111111010101111a11111111111111111111101111011111011001111110111111101110101011111101011111001111111101111011a110101a11111111011101111110101
111101101111111110011111110111111111a11111111111111101111111110110111111011011111111111111111011111101111011101011100110101110111a111111a10101111111111111111111
111111111110111111111110101100111010a10111111111111111112210122211121001111121120111222111111111111111111111110011110101100111111a101011a11111111110111111101100
aaaaaaaaaaaaaaaaaaaaaaaaaaaaaaaaaaaaa10101011111111111112201112212022001112221011022111110111110101111111111111111111111111110110a111111a11111111110111101111101
011111111111110111111111011011010100111110111011100110111221211122222220101111021102201011011111010111110110111101101111101111101a111110a11110100111011111110110
11101111111111101111111111101111111010101111111111110111222110122202222212002abbbabbbaaaaaaaaaaaaaaaaaaaaaaaaaaaaaaaa111101001101a110111a11011101111111111001101
10010111111111110110110101111110011111111111111011010101122002122101212222110a10222021211110111111111111011111111001a110011111111a110011a00111101111101111111011
11111111001011111100110111111110011111111111111111100011222222101211101111121b21211121211111111111101010111011011111a011111100110a111111a11111111111111010110011
10111110110111101111011111110111111011101011101101110111211221222212212021111a20220021111111111101101111111101100000a001111110011a011011a10111101110111101111111
11101110111111111111110000111111110111111010100111111011011222211022220011112a02222212211111110111111101111111101101a101111001111a111111a11111111111011111111101
11111111111111111110111010010101111111111110111110001101122222010111121220102b12101011011111101111111111111111111100a011101011111a111001a01011111111111110100111
10011011111101011111111101111011111001011010101111101111222010210211111112110a11012011110011111111111111111100111111a111111011111a011110a11111101010111001111111
11111001111101110011011011011011111100011111001001111111221111022222101120212b21122201211110011110111110111111100100a111111011111a101101a01111111111111100111110
10111111111110010011111111111101110101111111111111111110112122222222202011012b22021110110111111111111011111100111111a110111000011a100011a11111111101110111101111
11010110111111111111110111111111110110111111001100011111212210212201020110110b10221222001111011111111111111111111111a110111110111a111111a11111111111110111111111
10111101101110011111111111101111100001011111110111111111221110200102100210222b11120121111101111000111110110111110011a111111011111a111101a11111110011111011011111
11111011111100111000011100111111110011111111111111111001111121102120212122111b20222020111111110001111111110110011111a010111010101a111111a11111110111010111111101
11110110111111111101110111001001111111011111111101011111121221210011111002101b00121120101011111110101111111111110110a111111111111a100101a11111111111111100111111
11110111101110101101011111111101011111001111110011111100222121011221021221121b01222012110111010101011101010101011111a111101111111a011111a00110110010100011111111
10111101111010111011101001011111110101101111110111100111222121112202122211001a22211211211011110011011110111111110111a111111111110a110110a11111111101111111100101
11011101101110011111111111111110111111110111111100111101221222221210001221120a02202202211110111111111111111111111111a111011111111a011000a11111011111111111010101
10110011111111111111101111101110011011111111011110011111112122012121221112110a00222100101111111111101001101110111101a011111111111a110111a01101111011110011110101
00111111111111011101111101011111111101111011111110001111120202020202122222212a02210222011111111111111001011111111111a111101101111a111111a11111111111111111111101
11111011111011110011101111111110110001111111001111011110221211112002102122221a11012112211111111111110111011111001101a110010111111a101110a11110011111101101110101
11111011111111111101111101111011101111101111111111101111121212021121022121112bababbbabbaaaaaaaaaa0111001111101011011a000111001111a111101a01110111111011111111111
010111100010111111011110001111111010111111111110111111101012020222200222112110020112012101111011a1101110111111010110a111111111011a010101a11111101001110111011110
111111111111111101110111111101100101011111111101111111111212120220122021211211122012122110101101a1111110111011110111a101110001111a111111a11111111111110111011111
110111100110111101111111111111111111111101011111111111101121011011101111012111100212121011111110a0111111011011111100a110000111111a011001a11111011110011111111100
111111111110111111111111100110111110110122220101121221222222122200220122111002022212100010111100a0010101111011001110a111111010111a011010a11111110011101111011111
011111101010110111111111111011111111111121112112201201221020020212212212110112022101101111111010a1011101011111111111a101111111111a110100a11111011111111100101011
100111111111111010111101111011111111111121210202002112222220222222222022101002121001122110101111a1111111111111111110a111111101011a010101a00111111010111101111010
111111110011110111100001111011011111011122020011112202112212202121121211122211002122202011011111a1011111011110101110a111111111110a000101a01010011111110011000111
110111101110111110111011101111011111101112212101022111102222120222211022011211111212110001111111a1111111000101101110a111111101111a110110a00111111000110101111111
100111011111110100111110011111101111011020211210222221021122212100210201100110110101011111101111a1011111111111000111a111111001011a011111a01100111101101000111111
101111110011110110111111111110011111111021101112211121022101212112120120111011111111101111111111a1101100110110110111a111110011110a011110a01010111101111011110111
110101101111101111111111111011110111011121001102210102212211212210121211110101111011100111111111a1111111011111111001a111111011110a111111a11111111110110111110111
111011011111111111111110111111110111111101201120111021011101102020021111111011101111111111111001a1001111111101100111a111110111111a011111a10111111101101111111101
010011011111110111111111011111111111111122121111211222112212200201121001111100001011111100110101a0111111111101101111a111111110110a111111a11001111111101101111110
011111100011111111111011100011111111111122221012201112010111222001211221111111111111110011101011a1100001111101011110a111111111111a111110a11111010111101111100111
101011001111111110011111110111111110111120201200222221121221020221200221101111100111111111011111a1111111101110011010a110101011111a101110a01001000111111111110010
111011111011011011110101011111111010011121111122111122111121121120100211111111001111111101011011a1111111101111101111a011111111011a110110a11111111111111110110111
110011111111111110111111111101110101001102120002110111212111022122112101101111011111011111111001a1111101101110100111a111111111111a001110a11111110101110111111110
111101111001001111111101111111111001101022012112210202000201121221022111100100111111110111111111a0111100110111111100a101111001000a101001a11111111111110111101100
111111111111011011110111101111101111111111112212120100202220211112001111111111111101111111111111a1111111010100110111a010011011110a111101a11011111010101111110111